Game-Piece:
# #
###
# #
Map:
000000
112211
123321
123321
113311
133331
113311
112211
122221
113311
123321
123321
112211
